20 6 80
--------------------
---------#----------
--------###---------
-------#####--------
--------------------
--------------------