20 6 60
--------------------
---------#----------
--------###---------
-------#####--------
--------------------
--------------------